 0,75		 0,75		 0,75		 0,75		 0,75		   -2		   -2		   -2		   -2		   -2		   -2		   -2		   -2		   -2		
   -1		    1		   -1		 0,75		   -1		   -2		   -2		   -2		   -2		   -2		   -2		   -2		   -2		   -2		
  1,3		   -1		   -1		 0,75		    1		   -2		   -2		   -2		   -2		   -2		   -2		   -2		   -2		   -2		
  1,3		  1,3		  1,3		 0,75		   -1		   -2		   -2		   -2		   -2		   -2		   -2		   -2		   -2		   -2		
   -1		  1,3		   -1		   -2		   -2		   -2		   -2		   -2		   -2		   -2		   -2		   -2		   -2		   -2		
  1,3		   -2		   -2		   -2		   -2		   -2		   -2		   -2		   -2		   -2		   -2		   -2		   -2		   -2		
   -2		   -2		   -2		   -2		   -2		   -2		   -2		   -2		   -2		   -2		   -2		   -2		   -2		   -2		
   -2		   -2		   -2		   -2		   -2		   -2		   -2		   -2		   -2		   -2		   -2		   -2		   -2		   -2		
   -2		   -2		   -2		   -2		   -2		   -2		   -2		   -2		   -2		   -2		   -2		   -2		   -2		   -2		
   -2		   -2		   -2		   -2		   -2		   -2		   -2		   -2		   -2		   -2		   -2		   -2		   -2		   -2		
   -2		   -2		   -2		   -2		   -2		   -2		   -2		   -2		   -2		   -2		   -2		   -2		   -2		   -2		
   -2		   -2		   -2		   -2		   -2		   -2		   -2		   -2		   -2		   -2		   -2		   -2		   -2		   -2		
   -2		   -2		   -2		   -2		   -2		   -2		   -2		   -2		   -2		   -2		   -2		   -2		   -2		   -2		
   -2		   -2		   -2		   -2		   -2		   -2		   -2		   -2		   -2		   -2		   -2		   -2		   -2		   -2		
